Aanrud Hans 	 {Title: None, Name blocks count: 2, Abbreviated components count: 0}
Aaronsohn Alexander 	 {Title: None, Name blocks count: 2, Abbreviated components count: 0}
Abad Faciolince Héctor 	 {Title: None, Name blocks count: 3, Abbreviated components count: 0}
Abani Christopher 	 {Title: None, Name blocks count: 2, Abbreviated components count: 0}
Abasiyanik Faik Sait 	 {Title: None, Name blocks count: 3, Abbreviated components count: 0}
Abbey Christina 	 {Title: None, Name blocks count: 2, Abbreviated components count: 0}
Abbey Edward 	 {Title: None, Name blocks count: 2, Abbreviated components count: 0}
Abbey Lynn 	 {Title: None, Name blocks count: 2, Abbreviated components count: 0}
A. Abbott Edwin 	 {Title: None, Name blocks count: 3, Abbreviated components count: 1}
Abbott Eleanor Hallowell 	 {Title: None, Name blocks count: 3, Abbreviated components count: 0}
Abbott Frederick George 	 {Title: None, Name blocks count: 3, Abbreviated components count: 0}
Abbott Jacob 	 {Title: None, Name blocks count: 2, Abbreviated components count: 0}
Abbott C. John S. 	 {Title: None, Name blocks count: 4, Abbreviated components count: 2}
Hajj Mohammed al-Abdari al-Fasi ibn 	 {Title: None, Name blocks count: 5, Abbreviated components count: 0}
Mohammed al-Abdari al-Hihi 	 {Title: None, Name blocks count: 3, Abbreviated components count: 0}
Abdelkrim al-Khattabi 	 {Title: None, Name blocks count: 2, Abbreviated components count: 0}
Abd al-Fasi al-Qadir 	 {Title: None, Name blocks count: 3, Abbreviated components count: 0}
Abe Kobo 	 {Title: None, Name blocks count: 2, Abbreviated components count: 0}
Abelard Peter 	 {Title: None, Name blocks count: 2, Abbreviated components count: 0}
Abernathy Robert 	 {Title: None, Name blocks count: 2, Abbreviated components count: 0}
Abouzeid Leila 	 {Title: None, Name blocks count: 2, Abbreviated components count: 0}
Abrahams Marc 	 {Title: None, Name blocks count: 2, Abbreviated components count: 0}
Abu al-Abbas as-Sabti 	 {Title: None, Name blocks count: 3, Abbreviated components count: 0}
Abu Imran al-Fasi 	 {Title: None, Name blocks count: 3, Abbreviated components count: 0}
Abu Mohammed Muqri al-Battiwi 	 {Title: None, Name blocks count: 4, Abbreviated components count: 0}
Abramowitz Milton 	 {Title: None, Name blocks count: 2, Abbreviated components count: 0}
Achaari Mohammed 	 {Title: None, Name blocks count: 2, Abbreviated components count: 0}
Achebe Chinua 	 {Title: None, Name blocks count: 2, Abbreviated components count: 0}
Achtouk Said 	 {Title: None, Name blocks count: 2, Abbreviated components count: 0}
Aciman André 	 {Title: None, Name blocks count: 2, Abbreviated components count: 0}
Ackerman Forrest J. 	 {Title: None, Name blocks count: 3, Abbreviated components count: 1}
Adams Douglas 	 {Title: None, Name blocks count: 2, Abbreviated components count: 0}
Adams Richard 	 {Title: None, Name blocks count: 2, Abbreviated components count: 0}
Adams Robert 	 {Title: None, Name blocks count: 2, Abbreviated components count: 0}
Abd Adarrak al-Wahhab 	 {Title: None, Name blocks count: 3, Abbreviated components count: 0}
Adeeb Mirza 	 {Title: None, Name blocks count: 2, Abbreviated components count: 0}
Adichie Chimamanda Ngozi 	 {Title: None, Name blocks count: 3, Abbreviated components count: 0}
Adivar Edip Halide 	 {Title: None, Name blocks count: 3, Abbreviated components count: 0}
Aesop 	 {Title: None, Name blocks count: 1, Abbreviated components count: 0}
Africanus Leo 	 {Title: None, Name blocks count: 2, Abbreviated components count: 0}
Agard John 	 {Title: None, Name blocks count: 2, Abbreviated components count: 0}
Agassi Shimon 	 {Title: None, Name blocks count: 2, Abbreviated components count: 0}
Aghmati Zechariah 	 {Title: None, Name blocks count: 2, Abbreviated components count: 0}
Ahern Cecelia 	 {Title: None, Name blocks count: 2, Abbreviated components count: 0}
Ahern Edward 	 {Title: None, Name blocks count: 2, Abbreviated components count: 0}
Ahern Jerry 	 {Title: None, Name blocks count: 2, Abbreviated components count: 0}
Ahmad Najiba 	 {Title: None, Name blocks count: 2, Abbreviated components count: 0}
Ahmet Pasa Vefik 	 {Title: None, Name blocks count: 3, Abbreviated components count: 0}
Aho Alfred 	 {Title: None, Name blocks count: 2, Abbreviated components count: 0}
Aidoo Ama Ata 	 {Title: None, Name blocks count: 3, Abbreviated components count: 0}
Aiken Conrad 	 {Title: None, Name blocks count: 2, Abbreviated components count: 0}
Akcura Yusuf 	 {Title: None, Name blocks count: 2, Abbreviated components count: 0}
Akensus Mohammed 	 {Title: None, Name blocks count: 2, Abbreviated components count: 0}
Abd al-Alami as-Salam 	 {Title: None, Name blocks count: 3, Abbreviated components count: 0}
Alami Mohammed Mohammed ibn 	 {Title: None, Name blocks count: 4, Abbreviated components count: 0}
Mohammed al-Alami al-Tayyib ibn 	 {Title: None, Name blocks count: 4, Abbreviated components count: 0}
Idriss al-Alami al-Hassan ibn 	 {Title: None, Name blocks count: 4, Abbreviated components count: 0}
Alamy El Kaddour 	 {Title: None, Name blocks count: 3, Abbreviated components count: 0}
Ahmad Aldj al-Tayyeb 	 {Title: None, Name blocks count: 3, Abbreviated components count: 0}
Alatli Alev 	 {Title: None, Name blocks count: 2, Abbreviated components count: 0}
Albee Edward 	 {Title: None, Name blocks count: 2, Abbreviated components count: 0}
Albert Susan Wittig 	 {Title: None, Name blocks count: 3, Abbreviated components count: 0}
Albom Mitch 	 {Title: None, Name blocks count: 2, Abbreviated components count: 0}
Alcott Louisa May 	 {Title: None, Name blocks count: 3, Abbreviated components count: 0}
Aldersey-Williams Hugh 	 {Title: None, Name blocks count: 2, Abbreviated components count: 0}
Aldiss Brian 	 {Title: None, Name blocks count: 2, Abbreviated components count: 0}
Alers Rochelle 	 {Title: None, Name blocks count: 2, Abbreviated components count: 0}
Alfasi Isaac 	 {Title: None, Name blocks count: 2, Abbreviated components count: 0}
Jean Le Rond d'Alembert 	 {Title: None, Name blocks count: 4, Abbreviated components count: 0}
Alexander Kate 	 {Title: None, Name blocks count: 2, Abbreviated components count: 0}
Alexander Lloyd 	 {Title: None, Name blocks count: 2, Abbreviated components count: 0}
Alexander Trisha 	 {Title: None, Name blocks count: 2, Abbreviated components count: 0}
Alexie Sherman 	 {Title: None, Name blocks count: 2, Abbreviated components count: 0}
Alire Benjamin Sáenz 	 {Title: None, Name blocks count: 3, Abbreviated components count: 0}
Allal Tewfik 	 {Title: None, Name blocks count: 2, Abbreviated components count: 0}
Allen Barbara 	 {Title: None, Name blocks count: 2, Abbreviated components count: 0}
Allen Charlotte Vale 	 {Title: None, Name blocks count: 3, Abbreviated components count: 0}
Allen John 	 {Title: None, Name blocks count: 2, Abbreviated components count: 0}
Allen John 	 {Title: None, Name blocks count: 2, Abbreviated components count: 0}
Allen MacBride Roger 	 {Title: None, Name blocks count: 3, Abbreviated components count: 0}
Allen B. Thomas 	 {Title: None, Name blocks count: 3, Abbreviated components count: 1}
Allende Isabel 	 {Title: None, Name blocks count: 2, Abbreviated components count: 0}
Almeida Germano 	 {Title: None, Name blocks count: 2, Abbreviated components count: 0}
Almond David 	 {Title: None, Name blocks count: 2, Abbreviated components count: 0}
Almond Steve 	 {Title: None, Name blocks count: 2, Abbreviated components count: 0}
Alten Steve 	 {Title: None, Name blocks count: 2, Abbreviated components count: 0}
Alexander Altsheler Joseph 	 {Title: None, Name blocks count: 3, Abbreviated components count: 0}
Altshuler Mor 	 {Title: None, Name blocks count: 2, Abbreviated components count: 0}
Amalrik Andrej 	 {Title: None, Name blocks count: 2, Abbreviated components count: 0}
Ambler Eric 	 {Title: None, Name blocks count: 2, Abbreviated components count: 0}
Amburn Ellis 	 {Title: None, Name blocks count: 2, Abbreviated components count: 0}
Amis Kingsley 	 {Title: None, Name blocks count: 2, Abbreviated components count: 0}
Amis Martin 	 {Title: None, Name blocks count: 2, Abbreviated components count: 0}
Idriss al-Amraoui 	 {Title: None, Name blocks count: 2, Abbreviated components count: 0}
Idris Mohammed al-Amrawi ibn 	 {Title: None, Name blocks count: 4, Abbreviated components count: 0}
Anand Anurag 	 {Title: None, Name blocks count: 2, Abbreviated components count: 0}
Anaya Rudolfo 	 {Title: None, Name blocks count: 2, Abbreviated components count: 0}
Andersen Christian Hans 	 {Title: None, Name blocks count: 3, Abbreviated components count: 0}
Andersen Susan 	 {Title: None, Name blocks count: 2, Abbreviated components count: 0}
Anderson Catherine 	 {Title: None, Name blocks count: 2, Abbreviated components count: 0}
Anderson J. Kevin 	 {Title: None, Name blocks count: 3, Abbreviated components count: 1}
Anderson Matthew Tobin 	 {Title: None, Name blocks count: 3, Abbreviated components count: 0}
Anderson Poul 	 {Title: None, Name blocks count: 2, Abbreviated components count: 0}
Andrews C. V. 	 {Title: None, Name blocks count: 3, Abbreviated components count: 2}
Andric Ivo 	 {Title: None, Name blocks count: 2, Abbreviated components count: 0}
Angelou Maya 	 {Title: None, Name blocks count: 2, Abbreviated components count: 0}
Anna Threes 	 {Title: None, Name blocks count: 2, Abbreviated components count: 0}
Ansari Khwaja Latif Muhammad 	 {Title: None, Name blocks count: 4, Abbreviated components count: 0}
Anthony Piers 	 {Title: None, Name blocks count: 2, Abbreviated components count: 0}
Anvil Christopher 	 {Title: None, Name blocks count: 2, Abbreviated components count: 0}
Anwood Robert 	 {Title: None, Name blocks count: 2, Abbreviated components count: 0}
Aoyama Gosho 	 {Title: None, Name blocks count: 2, Abbreviated components count: 0}
Apollinaire Guillaume 	 {Title: None, Name blocks count: 2, Abbreviated components count: 0}
Apostoloska Maja 	 {Title: None, Name blocks count: 2, Abbreviated components count: 0}
Appel Jacob M. 	 {Title: None, Name blocks count: 3, Abbreviated components count: 1}
Apple Max 	 {Title: None, Name blocks count: 2, Abbreviated components count: 0}
Appignanesi Lisa 	 {Title: None, Name blocks count: 2, Abbreviated components count: 0}
A. Applegate K. 	 {Title: None, Name blocks count: 3, Abbreviated components count: 2}
Apramian Lisa Rose 	 {Title: None, Name blocks count: 3, Abbreviated components count: 0}
Aquilina Pawlu 	 {Title: None, Name blocks count: 2, Abbreviated components count: 0}
Aragon Louis 	 {Title: None, Name blocks count: 2, Abbreviated components count: 0}
Mohammed al-Arbi al-Fasi 	 {Title: None, Name blocks count: 3, Abbreviated components count: 0}
Archer Jeffrey 	 {Title: None, Name blocks count: 2, Abbreviated components count: 0}
Archer Jennifer 	 {Title: None, Name blocks count: 2, Abbreviated components count: 0}
Aristophanes 	 {Title: None, Name blocks count: 1, Abbreviated components count: 0}
Aristotle 	 {Title: None, Name blocks count: 1, Abbreviated components count: 0}
Armstrong Tilly 	 {Title: None, Name blocks count: 2, Abbreviated components count: 0}
Armstrong H. William 	 {Title: None, Name blocks count: 3, Abbreviated components count: 1}
Arnab Deka Jan 	 {Title: None, Name blocks count: 3, Abbreviated components count: 0}
Arnauld Céline 	 {Title: None, Name blocks count: 2, Abbreviated components count: 0}
Arrabal Fernando 	 {Title: None, Name blocks count: 2, Abbreviated components count: 0}
Antonin Artaud 	 {Title: None, Name blocks count: 2, Abbreviated components count: 0}
Asaro Catherine 	 {Title: None, Name blocks count: 2, Abbreviated components count: 0}
Asher Jay 	 {Title: None, Name blocks count: 2, Abbreviated components count: 0}
Asimov Isaac 	 {Title: None, Name blocks count: 2, Abbreviated components count: 0}
Asimov Janet 	 {Title: None, Name blocks count: 2, Abbreviated components count: 0}
Asprin Robert 	 {Title: None, Name blocks count: 2, Abbreviated components count: 0}
Asquith Clare 	 {Title: None, Name blocks count: 2, Abbreviated components count: 0}
Asquith Cynthia Lady 	 {Title: None, Name blocks count: 3, Abbreviated components count: 0}
Asturias Miguel Ángel 	 {Title: None, Name blocks count: 3, Abbreviated components count: 0}
Atkinson E. M. 	 {Title: None, Name blocks count: 3, Abbreviated components count: 2}
Atkinson Walker William 	 {Title: None, Name blocks count: 3, Abbreviated components count: 0}
Amelia Atwater-Rhodes 	 {Title: None, Name blocks count: 2, Abbreviated components count: 0}
Atwood Margaret 	 {Title: None, Name blocks count: 2, Abbreviated components count: 0}
Aucamp Hennie 	 {Title: None, Name blocks count: 2, Abbreviated components count: 0}
Augustine Hippo St of 	 {Title: None, Name blocks count: 4, Abbreviated components count: 0}
Auel Jean 	 {Title: None, Name blocks count: 2, Abbreviated components count: 0}
Augarde Steve 	 {Title: None, Name blocks count: 2, Abbreviated components count: 0}
Austen Jane 	 {Title: None, Name blocks count: 2, Abbreviated components count: 0}
Auster Paul 	 {Title: None, Name blocks count: 2, Abbreviated components count: 0}
Austin G. Jane 	 {Title: None, Name blocks count: 3, Abbreviated components count: 1}
Awzal Mohammed 	 {Title: None, Name blocks count: 2, Abbreviated components count: 0}
Axelson Jan 	 {Title: None, Name blocks count: 2, Abbreviated components count: 0}
Ayme Marcel 	 {Title: None, Name blocks count: 2, Abbreviated components count: 0}
Abu Salim al-Ayyashi 	 {Title: None, Name blocks count: 3, Abbreviated components count: 0}
Ayouch Nabil 	 {Title: None, Name blocks count: 2, Abbreviated components count: 0}
Ayyad Moussa Qadi ben 	 {Title: None, Name blocks count: 4, Abbreviated components count: 0}
Ali Azaykou 	 {Title: None, Name blocks count: 2, Abbreviated components count: 0}
Abu al-Abbas al-Azafi 	 {Title: None, Name blocks count: 3, Abbreviated components count: 0}
Aaron Chiundura Moyo 	 {Title: None, Name blocks count: 3, Abbreviated components count: 0}
Backman Fredrik 	 {Title: None, Name blocks count: 2, Abbreviated components count: 0}
Abd al-Badisi al-Haqq 	 {Title: None, Name blocks count: 3, Abbreviated components count: 0}
Badoe Yaba 	 {Title: None, Name blocks count: 2, Abbreviated components count: 0}
Bagnold Enid 	 {Title: None, Name blocks count: 2, Abbreviated components count: 0}
Bagshawe Louise 	 {Title: None, Name blocks count: 2, Abbreviated components count: 0}
Bailey Paul 	 {Title: None, Name blocks count: 2, Abbreviated components count: 0}
Baka Latifa 	 {Title: None, Name blocks count: 2, Abbreviated components count: 0}
Anne Baker 	 {Title: None, Name blocks count: 2, Abbreviated components count: 0}
Baker Deb 	 {Title: None, Name blocks count: 2, Abbreviated components count: 0}
Baker James Robert 	 {Title: None, Name blocks count: 3, Abbreviated components count: 0}
Baker Kage 	 {Title: None, Name blocks count: 2, Abbreviated components count: 0}
Bakker R. Scott 	 {Title: None, Name blocks count: 3, Abbreviated components count: 1}
Baldacci David 	 {Title: None, Name blocks count: 2, Abbreviated components count: 0}
Baldwin Faith 	 {Title: None, Name blocks count: 2, Abbreviated components count: 0}
Baldwin James 	 {Title: None, Name blocks count: 2, Abbreviated components count: 0}
Ballard Carol 	 {Title: None, Name blocks count: 2, Abbreviated components count: 0}
Ballard JG 	 {Title: None, Name blocks count: 2, Abbreviated components count: 0}
Ballard Todhunter 	 {Title: None, Name blocks count: 2, Abbreviated components count: 0}
Balliett Blue 	 {Title: None, Name blocks count: 2, Abbreviated components count: 0}
Balogh Mary 	 {Title: None, Name blocks count: 2, Abbreviated components count: 0}
Balzac Honoré de 	 {Title: None, Name blocks count: 3, Abbreviated components count: 0}
Bandele Biyi 	 {Title: None, Name blocks count: 2, Abbreviated components count: 0}
Banks Iain M. 	 {Title: None, Name blocks count: 3, Abbreviated components count: 1}
Banks Lynne Reid 	 {Title: None, Name blocks count: 3, Abbreviated components count: 0}
Banks Russell 	 {Title: None, Name blocks count: 2, Abbreviated components count: 0}
Bannerman Helen 	 {Title: None, Name blocks count: 2, Abbreviated components count: 0}
Ann Bannon 	 {Title: None, Name blocks count: 2, Abbreviated components count: 0}
Barbery Muriel 	 {Title: None, Name blocks count: 2, Abbreviated components count: 0}
Bardsley Michele 	 {Title: None, Name blocks count: 2, Abbreviated components count: 0}
Barer Burl 	 {Title: None, Name blocks count: 2, Abbreviated components count: 0}
Alessandro Baricco 	 {Title: None, Name blocks count: 2, Abbreviated components count: 0}
Baring-Gould Sabine 	 {Title: None, Name blocks count: 2, Abbreviated components count: 0}
Barjavel René 	 {Title: None, Name blocks count: 2, Abbreviated components count: 0}
Barker Dan 	 {Title: None, Name blocks count: 2, Abbreviated components count: 0}
Barlough E. Jeffrey 	 {Title: None, Name blocks count: 3, Abbreviated components count: 1}
Barnard D. Neal 	 {Title: None, Name blocks count: 3, Abbreviated components count: 1}
Barnes Eric J. 	 {Title: None, Name blocks count: 3, Abbreviated components count: 1}
Barnes John 	 {Title: None, Name blocks count: 2, Abbreviated components count: 0}
Barnes Julian 	 {Title: None, Name blocks count: 2, Abbreviated components count: 0}
Barnes Steven 	 {Title: None, Name blocks count: 2, Abbreviated components count: 0}
Barnes C. Will 	 {Title: None, Name blocks count: 3, Abbreviated components count: 1}
Barnett Jill 	 {Title: None, Name blocks count: 2, Abbreviated components count: 0}
Barnhardt Wilton 	 {Title: None, Name blocks count: 2, Abbreviated components count: 0}
Barr Nevada 	 {Title: None, Name blocks count: 2, Abbreviated components count: 0}
Barrell Tony 	 {Title: None, Name blocks count: 2, Abbreviated components count: 0}
Andrea Barrett 	 {Title: None, Name blocks count: 2, Abbreviated components count: 0}
Barrett Jo 	 {Title: None, Name blocks count: 2, Abbreviated components count: 0}
Barrett Lindsay 	 {Title: None, Name blocks count: 2, Abbreviated components count: 0}
Barrett Lynne 	 {Title: None, Name blocks count: 2, Abbreviated components count: 0}
Barrie J. M. 	 {Title: None, Name blocks count: 3, Abbreviated components count: 2}
Barrowcliffe Mark 	 {Title: None, Name blocks count: 2, Abbreviated components count: 0}
Angela Barry 	 {Title: None, Name blocks count: 2, Abbreviated components count: 0}
Barry Dave 	 {Title: None, Name blocks count: 2, Abbreviated components count: 0}
Barry Max 	 {Title: None, Name blocks count: 2, Abbreviated components count: 0}
Barth John 	 {Title: None, Name blocks count: 2, Abbreviated components count: 0}
Barton David 	 {Title: None, Name blocks count: 2, Abbreviated components count: 0}
Bass J. T. 	 {Title: None, Name blocks count: 3, Abbreviated components count: 2}
Bastiat Frédéric 	 {Title: None, Name blocks count: 2, Abbreviated components count: 0}
Bataille Georges 	 {Title: None, Name blocks count: 2, Abbreviated components count: 0}
Bateman James 	 {Title: None, Name blocks count: 2, Abbreviated components count: 0}
Arlo Bates 	 {Title: None, Name blocks count: 2, Abbreviated components count: 0}
Bathanti Joseph 	 {Title: None, Name blocks count: 2, Abbreviated components count: 0}
Batma Laarbi 	 {Title: None, Name blocks count: 2, Abbreviated components count: 0}
Batson Thomas Wayne 	 {Title: None, Name blocks count: 3, Abbreviated components count: 0}
Batur Enis 	 {Title: None, Name blocks count: 2, Abbreviated components count: 0}
Baudelaire Charles Pierre 	 {Title: None, Name blocks count: 3, Abbreviated components count: 0}
Baum Frank L. 	 {Title: None, Name blocks count: 3, Abbreviated components count: 1}
Baxter Stephen 	 {Title: None, Name blocks count: 2, Abbreviated components count: 0}
Bayan Rick 	 {Title: None, Name blocks count: 2, Abbreviated components count: 0}
Mohammed al-Baydhaq 	 {Title: None, Name blocks count: 2, Abbreviated components count: 0}
"BB" 	 {Title: None, Name blocks count: 1, Abbreviated components count: 0}
Bear Greg 	 {Title: None, Name blocks count: 2, Abbreviated components count: 0}
Beasley Delilah L. 	 {Title: None, Name blocks count: 3, Abbreviated components count: 1}
Beason Doug 	 {Title: None, Name blocks count: 2, Abbreviated components count: 0}
Beauman Sally 	 {Title: None, Name blocks count: 2, Abbreviated components count: 0}
Beaumarchais Pierre 	 {Title: None, Name blocks count: 2, Abbreviated components count: 0}
Beaumont Charles 	 {Title: None, Name blocks count: 2, Abbreviated components count: 0}
Beaumont Jeanne-Marie Leprince de 	 {Title: None, Name blocks count: 4, Abbreviated components count: 0}
Beauvoir Simone de 	 {Title: None, Name blocks count: 3, Abbreviated components count: 0}
Bechard Margaret 	 {Title: None, Name blocks count: 2, Abbreviated components count: 0}
Becker Herbert L. 	 {Title: None, Name blocks count: 3, Abbreviated components count: 1}
Beckett Chris 	 {Title: None, Name blocks count: 2, Abbreviated components count: 0}
Beckett Samuel 	 {Title: None, Name blocks count: 2, Abbreviated components count: 0}
Adolfo Bécquer Gustavo 	 {Title: None, Name blocks count: 3, Abbreviated components count: 0}
B. Bedford Jimmy 	 {Title: None, Name blocks count: 3, Abbreviated components count: 1}
Bedford Simi 	 {Title: None, Name blocks count: 2, Abbreviated components count: 0}
Albrecht Behmel 	 {Title: None, Name blocks count: 2, Abbreviated components count: 0}
Bell Horace 	 {Title: None, Name blocks count: 2, Abbreviated components count: 0}
Bellairs John 	 {Title: None, Name blocks count: 2, Abbreviated components count: 0}
Belloc Hillaire 	 {Title: None, Name blocks count: 2, Abbreviated components count: 0}
Bellow Saul 	 {Title: None, Name blocks count: 2, Abbreviated components count: 0}
Abraham David al-Fasi ben 	 {Title: None, Name blocks count: 4, Abbreviated components count: 0}
Ben Brahim Mohammed 	 {Title: None, Name blocks count: 3, Abbreviated components count: 0}
Benchekroun Siham 	 {Title: None, Name blocks count: 2, Abbreviated components count: 0}
Ahmed Benchemsi 	 {Title: None, Name blocks count: 2, Abbreviated components count: 0}
Benchemsi Rajae 	 {Title: None, Name blocks count: 2, Abbreviated components count: 0}
Benchley Peter 	 {Title: None, Name blocks count: 2, Abbreviated components count: 0}
Bendell Don 	 {Title: None, Name blocks count: 2, Abbreviated components count: 0}
Benet Juan 	 {Title: None, Name blocks count: 2, Abbreviated components count: 0}
Benford Gregory 	 {Title: None, Name blocks count: 2, Abbreviated components count: 0}
Bendahan Esther 	 {Title: None, Name blocks count: 2, Abbreviated components count: 0}
Abdelmajid Benjelloun 	 {Title: None, Name blocks count: 2, Abbreviated components count: 0}
Abdelmajid Benjelloun 	 {Title: None, Name blocks count: 2, Abbreviated components count: 0}
Ben Jelloun Tahar 	 {Title: None, Name blocks count: 3, Abbreviated components count: 0}
Dunash Labrat ben 	 {Title: None, Name blocks count: 3, Abbreviated components count: 0}
Abdeslam Ben Mchich 	 {Title: None, Name blocks count: 3, Abbreviated components count: 0}
Judah Nissim ben 	 {Title: None, Name blocks count: 3, Abbreviated components count: 0}
Bennani Mohammed Suerte 	 {Title: None, Name blocks count: 3, Abbreviated components count: 0}
Arnold Bennett 	 {Title: None, Name blocks count: 2, Abbreviated components count: 0}
Bennis Mohammed 	 {Title: None, Name blocks count: 2, Abbreviated components count: 0}
Bennouna Khnata 	 {Title: None, Name blocks count: 2, Abbreviated components count: 0}
Ben-Shahar Eran 	 {Title: None, Name blocks count: 2, Abbreviated components count: 0}
Bakkar Khnata bent 	 {Title: None, Name blocks count: 3, Abbreviated components count: 0}
Benzakour Mohammed 	 {Title: None, Name blocks count: 2, Abbreviated components count: 0}
Berechiah ha-Nakdan 	 {Title: None, Name blocks count: 2, Abbreviated components count: 0}
Berna Paul 	 {Title: None, Name blocks count: 2, Abbreviated components count: 0}
Berry Steve 	 {Title: None, Name blocks count: 2, Abbreviated components count: 0}
Berzon Betty 	 {Title: None, Name blocks count: 2, Abbreviated components count: 0}
Sir. Besant Walter 	 {Title: Sir, Name blocks count: 2, Abbreviated components count: 0}
Alfred Bester 	 {Title: None, Name blocks count: 2, Abbreviated components count: 0}
Bevarly Elizabeth 	 {Title: None, Name blocks count: 2, Abbreviated components count: 0}
Beverley Jo 	 {Title: None, Name blocks count: 2, Abbreviated components count: 0}
Bhabananda Deka 	 {Title: None, Name blocks count: 2, Abbreviated components count: 0}
Bibesco Elizabeth 	 {Title: None, Name blocks count: 2, Abbreviated components count: 0}
Birbal Jha 	 {Title: None, Name blocks count: 2, Abbreviated components count: 0}
Ambrose Bierce 	 {Title: None, Name blocks count: 2, Abbreviated components count: 0}
Biggers Derr Earl 	 {Title: None, Name blocks count: 3, Abbreviated components count: 0}
Binchy Maeve 	 {Title: None, Name blocks count: 2, Abbreviated components count: 0}
Binder Eando 	 {Title: None, Name blocks count: 2, Abbreviated components count: 0}
Bingham Charlotte 	 {Title: None, Name blocks count: 2, Abbreviated components count: 0}
Bird Christopher 	 {Title: None, Name blocks count: 2, Abbreviated components count: 0}
Bird Jessica 	 {Title: None, Name blocks count: 2, Abbreviated components count: 0}
Birnbaum Stephen 	 {Title: None, Name blocks count: 2, Abbreviated components count: 0}
Bisson Terry 	 {Title: None, Name blocks count: 2, Abbreviated components count: 0}
Bixby Jerome 	 {Title: None, Name blocks count: 2, Abbreviated components count: 0}
Black Jenna 	 {Title: None, Name blocks count: 2, Abbreviated components count: 0}
Black William 	 {Title: None, Name blocks count: 2, Abbreviated components count: 0}
Blackman Malorie 	 {Title: None, Name blocks count: 2, Abbreviated components count: 0}
Blau Yaakov 	 {Title: None, Name blocks count: 2, Abbreviated components count: 0}
Blayne Diana 	 {Title: None, Name blocks count: 2, Abbreviated components count: 0}
Blair Emma Helen 	 {Title: None, Name blocks count: 3, Abbreviated components count: 0}
Blake Jennifer 	 {Title: None, Name blocks count: 2, Abbreviated components count: 0}
Blake J. William 	 {Title: None, Name blocks count: 3, Abbreviated components count: 1}
August Blanche 	 {Title: None, Name blocks count: 2, Abbreviated components count: 0}
Blank Hanne 	 {Title: None, Name blocks count: 2, Abbreviated components count: 0}
Blatty Peter William 	 {Title: None, Name blocks count: 3, Abbreviated components count: 0}
Blauner Peter 	 {Title: None, Name blocks count: 2, Abbreviated components count: 0}
Blaylock James P. 	 {Title: None, Name blocks count: 3, Abbreviated components count: 1}
Blish James 	 {Title: None, Name blocks count: 2, Abbreviated components count: 0}
Blishen Edward 	 {Title: None, Name blocks count: 2, Abbreviated components count: 0}
Bloch Robert 	 {Title: None, Name blocks count: 2, Abbreviated components count: 0}
Blume Judy 	 {Title: None, Name blocks count: 2, Abbreviated components count: 0}
Bly Robert 	 {Title: None, Name blocks count: 2, Abbreviated components count: 0}
Bly Mary 	 {Title: None, Name blocks count: 2, Abbreviated components count: 0}
Blyton Enid 	 {Title: None, Name blocks count: 2, Abbreviated components count: 0}
Böll Heinrich 	 {Title: None, Name blocks count: 2, Abbreviated components count: 0}
Bomans Godfried 	 {Title: None, Name blocks count: 2, Abbreviated components count: 0}
Bond Michael 	 {Title: None, Name blocks count: 2, Abbreviated components count: 0}
Bond Nelson S. 	 {Title: None, Name blocks count: 3, Abbreviated components count: 1}
Bond Ruskin 	 {Title: None, Name blocks count: 2, Abbreviated components count: 0}
Boone Kurt 	 {Title: None, Name blocks count: 2, Abbreviated components count: 0}
Bonnet Leslie 	 {Title: None, Name blocks count: 2, Abbreviated components count: 0}
Booth Stanley 	 {Title: None, Name blocks count: 2, Abbreviated components count: 0}
Borges Jorge Luis 	 {Title: None, Name blocks count: 3, Abbreviated components count: 0}
Bosman Charles Herman 	 {Title: None, Name blocks count: 3, Abbreviated components count: 0}
Boston Lucy M. 	 {Title: None, Name blocks count: 3, Abbreviated components count: 1}
Boswell James 	 {Title: None, Name blocks count: 2, Abbreviated components count: 0}
Allan Bosworth R. 	 {Title: None, Name blocks count: 3, Abbreviated components count: 1}
Allan Bosworth J. 	 {Title: None, Name blocks count: 3, Abbreviated components count: 1}
Anthony Boucher 	 {Title: None, Name blocks count: 2, Abbreviated components count: 0}
Ali Bourequat 	 {Title: None, Name blocks count: 2, Abbreviated components count: 0}
Ahmed Bouzfour 	 {Title: None, Name blocks count: 2, Abbreviated components count: 0}
Ben Bova 	 {Title: None, Name blocks count: 2, Abbreviated components count: 0}
Bovard James 	 {Title: None, Name blocks count: 2, Abbreviated components count: 0}
Boyd William 	 {Title: None, Name blocks count: 2, Abbreviated components count: 0}
Boyle Kay 	 {Title: None, Name blocks count: 2, Abbreviated components count: 0}
Boyne John 	 {Title: None, Name blocks count: 2, Abbreviated components count: 0}
Brackett Leigh 	 {Title: None, Name blocks count: 2, Abbreviated components count: 0}
Bradbury Ray 	 {Title: None, Name blocks count: 2, Abbreviated components count: 0}
Arthur Bradford 	 {Title: None, Name blocks count: 2, Abbreviated components count: 0}
Barbara Bradford Taylor 	 {Title: None, Name blocks count: 3, Abbreviated components count: 0}
Bradley Marion Zimmer 	 {Title: None, Name blocks count: 3, Abbreviated components count: 0}
Ann Brashares 	 {Title: None, Name blocks count: 2, Abbreviated components count: 0}
Breem Wallace 	 {Title: None, Name blocks count: 2, Abbreviated components count: 0}
Bremmer Ian 	 {Title: None, Name blocks count: 2, Abbreviated components count: 0}
Brennan Martin Stanislaus 	 {Title: None, Name blocks count: 3, Abbreviated components count: 0}
Brereton Frederick Sadleir 	 {Title: None, Name blocks count: 3, Abbreviated components count: 0}
Bretnor Reginald 	 {Title: None, Name blocks count: 2, Abbreviated components count: 0}
Brezina Thomas 	 {Title: None, Name blocks count: 2, Abbreviated components count: 0}
Briley John 	 {Title: None, Name blocks count: 2, Abbreviated components count: 0}
Brimson Dougie 	 {Title: None, Name blocks count: 2, Abbreviated components count: 0}
Brin David 	 {Title: None, Name blocks count: 2, Abbreviated components count: 0}
André Brink 	 {Title: None, Name blocks count: 2, Abbreviated components count: 0}
Annette Broadrick 	 {Title: None, Name blocks count: 2, Abbreviated components count: 0}
Brock James 	 {Title: None, Name blocks count: 2, Abbreviated components count: 0}
Brockway Connie 	 {Title: None, Name blocks count: 2, Abbreviated components count: 0}
Broderick Damien 	 {Title: None, Name blocks count: 2, Abbreviated components count: 0}
Brom Gerald 	 {Title: None, Name blocks count: 2, Abbreviated components count: 0}
Brome Vincent 	 {Title: None, Name blocks count: 2, Abbreviated components count: 0}
Bromfield Louis 	 {Title: None, Name blocks count: 2, Abbreviated components count: 0}
Anne Brontë 	 {Title: None, Name blocks count: 2, Abbreviated components count: 0}
Brontë Charlotte 	 {Title: None, Name blocks count: 2, Abbreviated components count: 0}
Brontë Emily 	 {Title: None, Name blocks count: 2, Abbreviated components count: 0}
Anita Brookner 	 {Title: None, Name blocks count: 2, Abbreviated components count: 0}
Brooke Lauren 	 {Title: None, Name blocks count: 2, Abbreviated components count: 0}
Brooke PJ 	 {Title: None, Name blocks count: 2, Abbreviated components count: 0}
Brooks Geraldine 	 {Title: None, Name blocks count: 2, Abbreviated components count: 0}
Brooks Gwendolyn 	 {Title: None, Name blocks count: 2, Abbreviated components count: 0}
Brooks Kristi 	 {Title: None, Name blocks count: 2, Abbreviated components count: 0}
Brooks Terry 	 {Title: None, Name blocks count: 2, Abbreviated components count: 0}
Broughton Rhoda 	 {Title: None, Name blocks count: 2, Abbreviated components count: 0}
Brockden Brown Charles 	 {Title: None, Name blocks count: 3, Abbreviated components count: 0}
Brown Charles Hopel 	 {Title: None, Name blocks count: 3, Abbreviated components count: 0}
Brown Dan 	 {Title: None, Name blocks count: 2, Abbreviated components count: 0}
Brown Daniel James 	 {Title: None, Name blocks count: 3, Abbreviated components count: 0}
Brown Eric 	 {Title: None, Name blocks count: 2, Abbreviated components count: 0}
Brown Fredric 	 {Title: None, Name blocks count: 2, Abbreviated components count: 0}
Brown Marcia 	 {Title: None, Name blocks count: 2, Abbreviated components count: 0}
Brown Sandra 	 {Title: None, Name blocks count: 2, Abbreviated components count: 0}
A. Browne Gerald 	 {Title: None, Name blocks count: 3, Abbreviated components count: 1}
Browne Harry 	 {Title: None, Name blocks count: 2, Abbreviated components count: 0}
Sir. Browne Thomas 	 {Title: Sir, Name blocks count: 2, Abbreviated components count: 0}
Browning Dixie 	 {Title: None, Name blocks count: 2, Abbreviated components count: 0}
Anatole Broyard 	 {Title: None, Name blocks count: 2, Abbreviated components count: 0}
Brú Heðin 	 {Title: None, Name blocks count: 2, Abbreviated components count: 0}
Brueggemann Walter 	 {Title: None, Name blocks count: 2, Abbreviated components count: 0}
Brundu Rina 	 {Title: None, Name blocks count: 2, Abbreviated components count: 0}
Brunhoff Jean de 	 {Title: None, Name blocks count: 3, Abbreviated components count: 0}
Brunner John 	 {Title: None, Name blocks count: 2, Abbreviated components count: 0}
Brust Steven 	 {Title: None, Name blocks count: 2, Abbreviated components count: 0}
Bill Bryson 	 {Title: None, Name blocks count: 2, Abbreviated components count: 0}
Buchan Elizabeth 	 {Title: None, Name blocks count: 2, Abbreviated components count: 0}
Buchan John 	 {Title: None, Name blocks count: 2, Abbreviated components count: 0}
Anthony Buckeridge 	 {Title: None, Name blocks count: 2, Abbreviated components count: 0}
Buckingham Nancy 	 {Title: None, Name blocks count: 2, Abbreviated components count: 0}
Algis Budrys 	 {Title: None, Name blocks count: 2, Abbreviated components count: 0}
Buick Lindsay Thomas 	 {Title: None, Name blocks count: 3, Abbreviated components count: 0}
Bujold Lois McMaster 	 {Title: None, Name blocks count: 3, Abbreviated components count: 0}
Bukowski Charles 	 {Title: None, Name blocks count: 2, Abbreviated components count: 0}
Bulgakov Mikhail 	 {Title: None, Name blocks count: 2, Abbreviated components count: 0}
Bunyan John 	 {Title: None, Name blocks count: 2, Abbreviated components count: 0}
Burford Eleanor 	 {Title: None, Name blocks count: 2, Abbreviated components count: 0}
Alan Burgess 	 {Title: None, Name blocks count: 2, Abbreviated components count: 0}
Anthony Burgess 	 {Title: None, Name blocks count: 2, Abbreviated components count: 0}
Burnford Sheila 	 {Title: None, Name blocks count: 2, Abbreviated components count: 0}
Burnett Frances Hodgson 	 {Title: None, Name blocks count: 3, Abbreviated components count: 0}
Burney Frances 	 {Title: None, Name blocks count: 2, Abbreviated components count: 0}
Burney Sarah 	 {Title: None, Name blocks count: 2, Abbreviated components count: 0}
Burns Terry W. 	 {Title: None, Name blocks count: 3, Abbreviated components count: 1}
Bryan Burrough 	 {Title: None, Name blocks count: 2, Abbreviated components count: 0}
Augusten Burroughs Xon 	 {Title: None, Name blocks count: 3, Abbreviated components count: 0}
Burroughs Dillon 	 {Title: None, Name blocks count: 2, Abbreviated components count: 0}
Burroughs Edgar Rice 	 {Title: None, Name blocks count: 3, Abbreviated components count: 0}
Burroughs Franklin 	 {Title: None, Name blocks count: 2, Abbreviated components count: 0}
Burroughs S. William 	 {Title: None, Name blocks count: 3, Abbreviated components count: 1}
Burton Hester 	 {Title: None, Name blocks count: 2, Abbreviated components count: 0}
Burton Lee Virginia 	 {Title: None, Name blocks count: 3, Abbreviated components count: 0}
Butcher Jim 	 {Title: None, Name blocks count: 2, Abbreviated components count: 0}
Butler E. Octavia 	 {Title: None, Name blocks count: 3, Abbreviated components count: 1}
Bulkeley Butler Susan 	 {Title: None, Name blocks count: 3, Abbreviated components count: 0}
Buttigieg Ray 	 {Title: None, Name blocks count: 2, Abbreviated components count: 0}
A. Byatt S. 	 {Title: None, Name blocks count: 3, Abbreviated components count: 2}
Byrne John 	 {Title: None, Name blocks count: 2, Abbreviated components count: 0}
Byrne Paula 	 {Title: None, Name blocks count: 2, Abbreviated components count: 0}
Byrne Rhonda 	 {Title: None, Name blocks count: 2, Abbreviated components count: 0}
Branch Cabell James 	 {Title: None, Name blocks count: 3, Abbreviated components count: 0}
Cabot Meg 	 {Title: None, Name blocks count: 2, Abbreviated components count: 0}
Cain James M. 	 {Title: None, Name blocks count: 3, Abbreviated components count: 1}
Caldwell Erskine 	 {Title: None, Name blocks count: 2, Abbreviated components count: 0}
Cadigan Pat 	 {Title: None, Name blocks count: 2, Abbreviated components count: 0}
Andrea Cagan 	 {Title: None, Name blocks count: 2, Abbreviated components count: 0}
Cain Susan 	 {Title: None, Name blocks count: 2, Abbreviated components count: 0}
Brian Callison 	 {Title: None, Name blocks count: 2, Abbreviated components count: 0}
Cameron Eleanor 	 {Title: None, Name blocks count: 2, Abbreviated components count: 0}
Camp Candace 	 {Title: None, Name blocks count: 2, Abbreviated components count: 0}
Campbell John Jr W. 	 {Title: None, Name blocks count: 4, Abbreviated components count: 1}
Campbell Ramsey 	 {Title: None, Name blocks count: 2, Abbreviated components count: 0}
Albert Camus 	 {Title: None, Name blocks count: 2, Abbreviated components count: 0}
Canfield Jack 	 {Title: None, Name blocks count: 2, Abbreviated components count: 0}
Canin Ethan 	 {Title: None, Name blocks count: 2, Abbreviated components count: 0}
Capote Truman 	 {Title: None, Name blocks count: 2, Abbreviated components count: 0}
Card Orson Scott 	 {Title: None, Name blocks count: 3, Abbreviated components count: 0}
Carew Jan 	 {Title: None, Name blocks count: 2, Abbreviated components count: 0}
Carey Peter 	 {Title: None, Name blocks count: 2, Abbreviated components count: 0}
Carle Eric 	 {Title: None, Name blocks count: 2, Abbreviated components count: 0}
Carlyle Liz 	 {Title: None, Name blocks count: 2, Abbreviated components count: 0}
Carmichael Stokely 	 {Title: None, Name blocks count: 2, Abbreviated components count: 0}
Carmody Isobelle 	 {Title: None, Name blocks count: 2, Abbreviated components count: 0}
Carpeaux Maria Otto 	 {Title: None, Name blocks count: 3, Abbreviated components count: 0}
Carpenter Edmund Snow 	 {Title: None, Name blocks count: 3, Abbreviated components count: 0}
Carr Dickson John 	 {Title: None, Name blocks count: 3, Abbreviated components count: 0}
Carr Terry 	 {Title: None, Name blocks count: 2, Abbreviated components count: 0}
Carreras Julio 	 {Title: None, Name blocks count: 2, Abbreviated components count: 0}
Carroll Lewis 	 {Title: None, Name blocks count: 2, Abbreviated components count: 0}
Carr Philippa 	 {Title: None, Name blocks count: 2, Abbreviated components count: 0}
Carr Robyn 	 {Title: None, Name blocks count: 2, Abbreviated components count: 0}
Carré John le 	 {Title: None, Name blocks count: 3, Abbreviated components count: 0}
Carstens H. Harold 	 {Title: None, Name blocks count: 3, Abbreviated components count: 1}
Ally Carter 	 {Title: None, Name blocks count: 2, Abbreviated components count: 0}
Brian Carter 	 {Title: None, Name blocks count: 2, Abbreviated components count: 0}
Carter Lin 	 {Title: None, Name blocks count: 2, Abbreviated components count: 0}
Carter Martin 	 {Title: None, Name blocks count: 2, Abbreviated components count: 0}
Carter Peter 	 {Title: None, Name blocks count: 2, Abbreviated components count: 0}
Barbara Cartland 	 {Title: None, Name blocks count: 2, Abbreviated components count: 0}
Cartwright Justin 	 {Title: None, Name blocks count: 2, Abbreviated components count: 0}
Carver Jeffrey 	 {Title: None, Name blocks count: 2, Abbreviated components count: 0}
Carver Raymond 	 {Title: None, Name blocks count: 2, Abbreviated components count: 0}
Cary Kate 	 {Title: None, Name blocks count: 2, Abbreviated components count: 0}
Cashore Kristin 	 {Title: None, Name blocks count: 2, Abbreviated components count: 0}
Cass Zoe 	 {Title: None, Name blocks count: 2, Abbreviated components count: 0}
Cassady Neal 	 {Title: None, Name blocks count: 2, Abbreviated components count: 0}
Catalano Nick 	 {Title: None, Name blocks count: 2, Abbreviated components count: 0}
Cather Willa 	 {Title: None, Name blocks count: 2, Abbreviated components count: 0}
Cavendish Clare 	 {Title: None, Name blocks count: 2, Abbreviated components count: 0}
Cazet Denys 	 {Title: None, Name blocks count: 2, Abbreviated components count: 0}
Camilo Cela José 	 {Title: None, Name blocks count: 3, Abbreviated components count: 0}
Celal Peride 	 {Title: None, Name blocks count: 2, Abbreviated components count: 0}
Cervantes Miguel de 	 {Title: None, Name blocks count: 3, Abbreviated components count: 0}
Chabon Michael 	 {Title: None, Name blocks count: 2, Abbreviated components count: 0}
Dr. Angie Chabram-Dernersesian 	 {Title: Dr, Name blocks count: 2, Abbreviated components count: 0}
Chalker Jack L. 	 {Title: None, Name blocks count: 3, Abbreviated components count: 1}
Aidan Chambers 	 {Title: None, Name blocks count: 2, Abbreviated components count: 0}
A. Bertram Chandler 	 {Title: None, Name blocks count: 3, Abbreviated components count: 1}
Chandler Jessie 	 {Title: None, Name blocks count: 2, Abbreviated components count: 0}
Chandler Raymond 	 {Title: None, Name blocks count: 2, Abbreviated components count: 0}
Dr. Chang Stephen T. 	 {Title: Dr, Name blocks count: 3, Abbreviated components count: 1}
Chang Iris 	 {Title: None, Name blocks count: 2, Abbreviated components count: 0}
Channing Ellery William 	 {Title: None, Name blocks count: 3, Abbreviated components count: 0}
Chapman James 	 {Title: None, Name blocks count: 2, Abbreviated components count: 0}
Chaucer Geoffrey 	 {Title: None, Name blocks count: 2, Abbreviated components count: 0}
C. Chaudhuri Nirad 	 {Title: None, Name blocks count: 3, Abbreviated components count: 1}
Chase Hadley James 	 {Title: None, Name blocks count: 3, Abbreviated components count: 0}
Cheever John 	 {Title: None, Name blocks count: 2, Abbreviated components count: 0}
Anton Chekhov 	 {Title: None, Name blocks count: 2, Abbreviated components count: 0}
Chernow Ron 	 {Title: None, Name blocks count: 2, Abbreviated components count: 0}
C. Cherryh J. 	 {Title: None, Name blocks count: 3, Abbreviated components count: 2}
Cheshire Simon 	 {Title: None, Name blocks count: 2, Abbreviated components count: 0}
Chesney Marion 	 {Title: None, Name blocks count: 2, Abbreviated components count: 0}
Chesterton Denise 	 {Title: None, Name blocks count: 2, Abbreviated components count: 0}
Chesterton G. K. 	 {Title: None, Name blocks count: 3, Abbreviated components count: 2}
Chevalier Tracy 	 {Title: None, Name blocks count: 2, Abbreviated components count: 0}
Chiang Ted 	 {Title: None, Name blocks count: 2, Abbreviated components count: 0}
Child Lee 	 {Title: None, Name blocks count: 2, Abbreviated components count: 0}
Charles Chilton 	 {Title: None, Name blocks count: 2, Abbreviated components count: 0}
Cholmondeley Mary 	 {Title: None, Name blocks count: 2, Abbreviated components count: 0}
Chomsky Noam 	 {Title: None, Name blocks count: 2, Abbreviated components count: 0}
Chopra Deepak 	 {Title: None, Name blocks count: 2, Abbreviated components count: 0}
Chopin Kate 	 {Title: None, Name blocks count: 2, Abbreviated components count: 0}
Christian Jill 	 {Title: None, Name blocks count: 2, Abbreviated components count: 0}
Agatha Christie 	 {Title: None, Name blocks count: 2, Abbreviated components count: 0}
Christopher John 	 {Title: None, Name blocks count: 2, Abbreviated components count: 0}
Chowdhuri Rai Satyabrata 	 {Title: None, Name blocks count: 3, Abbreviated components count: 0}
Chubb Ralph 	 {Title: None, Name blocks count: 2, Abbreviated components count: 0}
Alfred Church John 	 {Title: None, Name blocks count: 3, Abbreviated components count: 0}
Churchill Winston 	 {Title: None, Name blocks count: 2, Abbreviated components count: 0}
Churchill Winston 	 {Title: None, Name blocks count: 2, Abbreviated components count: 0}
Ciencin Scott 	 {Title: None, Name blocks count: 2, Abbreviated components count: 0}
Cisneros Sandra 	 {Title: None, Name blocks count: 2, Abbreviated components count: 0}
Citino Robert 	 {Title: None, Name blocks count: 2, Abbreviated components count: 0}
Cioran Emil 	 {Title: None, Name blocks count: 2, Abbreviated components count: 0}
Clair Margaret St 	 {Title: None, Name blocks count: 3, Abbreviated components count: 0}
Clancy Tom 	 {Title: None, Name blocks count: 2, Abbreviated components count: 0}
Cassandra Clare 	 {Title: None, Name blocks count: 2, Abbreviated components count: 0}
Carol Clark Higgins 	 {Title: None, Name blocks count: 3, Abbreviated components count: 0}
Clark Higgins Mary 	 {Title: None, Name blocks count: 3, Abbreviated components count: 0}
Clark D. Thomas 	 {Title: None, Name blocks count: 3, Abbreviated components count: 1}
Arthur C. Clarke 	 {Title: None, Name blocks count: 3, Abbreviated components count: 1}
Clarke Pauline 	 {Title: None, Name blocks count: 2, Abbreviated components count: 0}
Clason George Samuel 	 {Title: None, Name blocks count: 3, Abbreviated components count: 0}
Claus Hugo 	 {Title: None, Name blocks count: 2, Abbreviated components count: 0}
Clayton Jo 	 {Title: None, Name blocks count: 2, Abbreviated components count: 0}
Clayton Meg Waite 	 {Title: None, Name blocks count: 3, Abbreviated components count: 0}
Beverly Cleary 	 {Title: None, Name blocks count: 2, Abbreviated components count: 0}
Cleary Jon 	 {Title: None, Name blocks count: 2, Abbreviated components count: 0}
Brian Cleeve 	 {Title: None, Name blocks count: 2, Abbreviated components count: 0}
Clemens Samuel 	 {Title: None, Name blocks count: 2, Abbreviated components count: 0}
Clement Hal 	 {Title: None, Name blocks count: 2, Abbreviated components count: 0}
Clifton Mark 	 {Title: None, Name blocks count: 2, Abbreviated components count: 0}
Cline Emma 	 {Title: None, Name blocks count: 2, Abbreviated components count: 0}
Cline Ernest 	 {Title: None, Name blocks count: 2, Abbreviated components count: 0}
Bill Clinton 	 {Title: None, Name blocks count: 2, Abbreviated components count: 0}
Brenda Clough 	 {Title: None, Name blocks count: 2, Abbreviated components count: 0}
Clymer Susan 	 {Title: None, Name blocks count: 2, Abbreviated components count: 0}
Coakley-Thompson Wendy 	 {Title: None, Name blocks count: 2, Abbreviated components count: 0}
Coates Sheila 	 {Title: None, Name blocks count: 2, Abbreviated components count: 0}
Coben Harlan 	 {Title: None, Name blocks count: 2, Abbreviated components count: 0}
A. Coblentz Stanton 	 {Title: None, Name blocks count: 3, Abbreviated components count: 1}
Cocteau Jean 	 {Title: None, Name blocks count: 2, Abbreviated components count: 0}
Coelho Paulo 	 {Title: None, Name blocks count: 2, Abbreviated components count: 0}
Coetzee John Maxwell 	 {Title: None, Name blocks count: 3, Abbreviated components count: 0}
Cohen H. Raphael 	 {Title: None, Name blocks count: 3, Abbreviated components count: 1}
Cohen Shaughnessy 	 {Title: None, Name blocks count: 2, Abbreviated components count: 0}
Colas Emily 	 {Title: None, Name blocks count: 2, Abbreviated components count: 0}
Coleridge Samuel Taylor 	 {Title: None, Name blocks count: 3, Abbreviated components count: 0}
Colette 	 {Title: None, Name blocks count: 1, Abbreviated components count: 0}
Colfer Eoin 	 {Title: None, Name blocks count: 2, Abbreviated components count: 0}
Collingwood Gershom William 	 {Title: None, Name blocks count: 3, Abbreviated components count: 0}
Collins Jackie 	 {Title: None, Name blocks count: 2, Abbreviated components count: 0}
Collins Larry 	 {Title: None, Name blocks count: 2, Abbreviated components count: 0}
Allan Collins Max 	 {Title: None, Name blocks count: 3, Abbreviated components count: 0}
Collins Suzanne 	 {Title: None, Name blocks count: 2, Abbreviated components count: 0}
Collins Michael 	 {Title: None, Name blocks count: 2, Abbreviated components count: 0}
Collins Norman 	 {Title: None, Name blocks count: 2, Abbreviated components count: 0}
Collins Wilkie 	 {Title: None, Name blocks count: 2, Abbreviated components count: 0}
"Collodi" Carlo Lorenzini 	 {Title: None, Name blocks count: 3, Abbreviated components count: 0}
Comstock Harriet Theresa 	 {Title: None, Name blocks count: 3, Abbreviated components count: 0}
Conklin Groff 	 {Title: None, Name blocks count: 2, Abbreviated components count: 0}
Congreve William 	 {Title: None, Name blocks count: 2, Abbreviated components count: 0}
Conly Jane Leslie 	 {Title: None, Name blocks count: 3, Abbreviated components count: 0}
Conrad Joseph 	 {Title: None, Name blocks count: 2, Abbreviated components count: 0}
Conrad Lauren 	 {Title: None, Name blocks count: 2, Abbreviated components count: 0}
Conway Damian 	 {Title: None, Name blocks count: 2, Abbreviated components count: 0}
Cook Glen 	 {Title: None, Name blocks count: 2, Abbreviated components count: 0}
Cook Robin 	 {Title: None, Name blocks count: 2, Abbreviated components count: 0}
Cooke Francis James 	 {Title: None, Name blocks count: 3, Abbreviated components count: 0}
Catherine Cookson 	 {Title: None, Name blocks count: 2, Abbreviated components count: 0}
Coolidge Susan 	 {Title: None, Name blocks count: 2, Abbreviated components count: 0}
B. Caroline Cooney 	 {Title: None, Name blocks count: 3, Abbreviated components count: 1}
Carolyn Cooper 	 {Title: None, Name blocks count: 2, Abbreviated components count: 0}
Cooper Dennis 	 {Title: None, Name blocks count: 2, Abbreviated components count: 0}
Cooper Glenn 	 {Title: None, Name blocks count: 2, Abbreviated components count: 0}
Cooper Fenimore James 	 {Title: None, Name blocks count: 3, Abbreviated components count: 0}
Cooper Jilly 	 {Title: None, Name blocks count: 2, Abbreviated components count: 0}
Cooper Susan 	 {Title: None, Name blocks count: 2, Abbreviated components count: 0}
Copeland Lori 	 {Title: None, Name blocks count: 2, Abbreviated components count: 0}
Corey Peter 	 {Title: None, Name blocks count: 2, Abbreviated components count: 0}
Bernard Cornwell 	 {Title: None, Name blocks count: 2, Abbreviated components count: 0}
Cornwell Patricia 	 {Title: None, Name blocks count: 2, Abbreviated components count: 0}
Cortázar Julio 	 {Title: None, Name blocks count: 2, Abbreviated components count: 0}
Sr. Cotter, Joseph Seamon 	 {Title: Sr, Name blocks count: 3, Abbreviated components count: 0}
Cotton John 	 {Title: None, Name blocks count: 2, Abbreviated components count: 0}
Catherine Coulter 	 {Title: None, Name blocks count: 2, Abbreviated components count: 0}
Coupland Douglas 	 {Title: None, Name blocks count: 2, Abbreviated components count: 0}
Courteline Georges 	 {Title: None, Name blocks count: 2, Abbreviated components count: 0}
Caroline Courtney 	 {Title: None, Name blocks count: 2, Abbreviated components count: 0}
Bruce Coville 	 {Title: None, Name blocks count: 2, Abbreviated components count: 0}
Cox Josephine 	 {Title: None, Name blocks count: 2, Abbreviated components count: 0}
Covey R. Stephen 	 {Title: None, Name blocks count: 3, Abbreviated components count: 1}
Covey Sean 	 {Title: None, Name blocks count: 2, Abbreviated components count: 0}
Amanda Craig 	 {Title: None, Name blocks count: 2, Abbreviated components count: 0}
Crais Robert 	 {Title: None, Name blocks count: 2, Abbreviated components count: 0}
Crane Stephen 	 {Title: None, Name blocks count: 2, Abbreviated components count: 0}
Crawford Max 	 {Title: None, Name blocks count: 2, Abbreviated components count: 0}
Creasey John 	 {Title: None, Name blocks count: 2, Abbreviated components count: 0}
Creech Sharon 	 {Title: None, Name blocks count: 2, Abbreviated components count: 0}
Crenshaw Dave 	 {Title: None, Name blocks count: 2, Abbreviated components count: 0}
Crespelle Jean-Paul 	 {Title: None, Name blocks count: 2, Abbreviated components count: 0}
Cresswell Helen 	 {Title: None, Name blocks count: 2, Abbreviated components count: 0}
Cresswell Jasmine 	 {Title: None, Name blocks count: 2, Abbreviated components count: 0}
Crichton Michael 	 {Title: None, Name blocks count: 2, Abbreviated components count: 0}
Criswell Millie 	 {Title: None, Name blocks count: 2, Abbreviated components count: 0}
Crompton Richmal 	 {Title: None, Name blocks count: 2, Abbreviated components count: 0}
A. Cronin J. 	 {Title: None, Name blocks count: 3, Abbreviated components count: 2}
Compton Crook N. 	 {Title: None, Name blocks count: 3, Abbreviated components count: 1}
Cross Gillian 	 {Title: None, Name blocks count: 2, Abbreviated components count: 0}
Blake Crouch 	 {Title: None, Name blocks count: 2, Abbreviated components count: 0}
Aleister Crowley 	 {Title: None, Name blocks count: 2, Abbreviated components count: 0}
Andrew Crumey 	 {Title: None, Name blocks count: 2, Abbreviated components count: 0}
Chris Culver 	 {Title: None, Name blocks count: 2, Abbreviated components count: 0}
Cummings E. E. 	 {Title: None, Name blocks count: 3, Abbreviated components count: 2}
Cuppy Will 	 {Title: None, Name blocks count: 2, Abbreviated components count: 0}
Christopher Curtis Paul 	 {Title: None, Name blocks count: 3, Abbreviated components count: 0}
Curtis Lionel 	 {Title: None, Name blocks count: 2, Abbreviated components count: 0}
Currie Katy 	 {Title: None, Name blocks count: 2, Abbreviated components count: 0}
Curry Jane Louise 	 {Title: None, Name blocks count: 3, Abbreviated components count: 0}
Curwood James Oliver 	 {Title: None, Name blocks count: 3, Abbreviated components count: 0}
Clive Cussler 	 {Title: None, Name blocks count: 2, Abbreviated components count: 0}
	 {Title: None, Name blocks count: 0, Abbreviated components count: 0}
